5절 연산자:
    	산술연산 : + - * / // % **
    	할당연산 : = += -= *= /= //= %=
    	논리연산 : & and | or not
    	비교연산 : > >= < <= == !=
    	비트연산 : & | ^
    	&와 |는 비교연산자보다 우선순위가 높다

6절 문자열:
	문자열 슬라이싱 변수[from:stop:step]
	len(문자열 변수) : 문자갯수
	upper() : 대문자로 변환
	lower() : 소문자로 변환
	title() : 각 어절의 첫 글자만 대문자로
	capitalize() : 첫문자만 대문자로
	count('찾을문자열') : '찾을문자열'이 몇개 들어있는지 갯수를 반환
	find('찾을문자열') : '찾을문자열'이 왼쪽부터 시작하여 몇번째 인덱스에 있는지 인덱스를 반환
	rfind('찾을문자열') : '찾을문자열'이 오른쪽부터 ....
        		**찾을문자열이 없다면 -1을 반환**
    		cf) index('찾을문자열') : '찾을문자열'의 인덱스 반환. 없다면 오류발생
	startswith('특정문자열') : '특정문자열'로 시작하는지 여부
	endswith('특정문자열') : '특정문자열'로 끝나는지 여부
	strip() : 좌우 공백 제거
	rstrip() : 오른쪽 공백 제거
	lstrip() : 왼쪽 공백 제거
	isdigit() : 문자열이 숫자문자열인지 여부
	islower() : 소문자문자열인지 여부
	isupper() : 대문자문자열인지 여부
	replace(oldStr, newStr) : oldStr을 newStr로 변경
	split(구분자) : 구분자를 이용해 문자 분리(리스트 반환)
	join(리스트) : 리스트를 연결

7절 날짜형:
	특정시점 : datetime(년,월,일,시,초)
	현재시점 : datetime.now()
	date(년,월,일) / datetime.now().date()
	time(시,분,초) / datetime.now().time()